333333333333333333333333333333333333333333-
333333333333333333333333333333333333333333-
333333333333333333333333333333333333333333-
333222222222232222112121222222322222222333-
333211121212202212222121211122022222252333-
333222221212232212112222212222322222222333-
333211333333333333333333333333333333333333-
333212333333333333333333333333333333333333-
333212212222223222221212222322222122122333-
333212212111220221221211122022122122112333-
333222222221223221222222122322122222222333-
333333333333333333333333333333333333212333-
333333333333333333333333333333333333222333-
333333333333333333333333333333333333303333-
333333333333333333333333333333333333222333-
333333333333333333333333333333333333222333-
333222212322122222122222122223222211212333-
333222212021122122121122121120221221212333-
333112222322222122222122222223221222222333-
333222333333333333333333333333333333333333-
333112333333333333333333333333333333333333-
333222333333333333333333333333333333333333-
333212333333333333333333333333333333333333-
333212222322222122222221223222122122222333-
333211212022112111211121120212112121222333-
333222212322222221212222223222222221112333-
333333333333333333333333333333333333222333-
333333333333333333333333333333333333112333-
333333333333333333333333333333333333222333-
333333333333333333333333333333333333112333-
333222212222122223222222211122212321212333-
333111212122121120221211212222212021212333-
333222222122222223221221212211222322222333-
333211333333333333333333333333333333333333-
333222333333333333333333333333333333333333-
333211333333333333333333333333333333333333-
333221222222122212212322222212222222222333-
333221112122122111212021211212122122242333-
333222222122222222212321222222222122222333-
333333333333333333333333333333333333333333-
333333333333333333333333333333333333333333-
333333333333333333333333333333333333333333